{
    "textures" : [
        {
            "id" : "barrel",
            "filename" : "resources/textures/barrel.png"
        },
        {
            "id" : "bucket",
            "fileName" : "resources/textures/bucket.png"
        },
        {
            "id" : "brickWall",
            "fileName" : "resources/textures/brickWall.png"
        },
        {
            "id" : "woodBrickWall",
            "fileName" : "resources/textures/woodBrickWall.png"
        },
        {
            "id" : "bookShelfWall",
            "fileName" : "resources/textures/bookShelfWall.png"
        },
        {
            "id" : "floor",
            "fileName" : "resources/textures/floor.png"
        },
        {
            "id" : "ceiling",
            "fileName" : "resources/textures/ceiling.png"
        }
    ],
    "map": {
        "width": 24,
        "height": 24,
        "data": [
            [2,2,2,2,2,2,2,2,2,2,2,2,2,2,2,2,1,1,1,1,1,1,1,1],
            [2,0,0,0,0,0,0,0,0,0,0,0,0,0,0,0,1,0,0,0,0,0,0,1],
            [2,0,3,0,0,0,0,0,0,0,0,0,0,0,0,0,0,0,0,0,0,0,0,1],
            [2,0,3,0,0,0,0,0,0,0,0,0,0,0,0,0,0,0,0,0,0,0,0,1],
            [2,0,3,0,0,0,0,0,0,0,0,0,0,0,0,0,1,0,0,0,0,0,0,1],
            [2,0,3,0,0,0,0,2,2,2,2,2,2,2,2,2,1,1,0,1,1,1,1,1],
            [2,0,3,0,0,0,0,2,0,2,0,2,0,2,0,2,1,0,0,0,1,1,1,1],
            [2,0,3,0,0,0,0,2,0,0,0,0,0,0,0,2,1,0,0,0,0,0,0,1],
            [2,0,3,0,0,0,0,0,0,0,0,0,0,0,0,0,0,0,0,0,1,1,1,1],
            [2,0,3,0,0,0,0,2,0,0,0,0,0,0,0,2,1,0,0,0,0,0,0,1],
            [2,0,0,0,0,0,0,2,0,0,0,0,0,0,0,2,1,0,0,0,1,1,1,1],
            [2,0,0,0,0,0,0,2,2,2,2,0,2,2,2,2,1,1,1,1,1,1,1,1],
            [2,2,2,2,2,2,2,2,2,2,2,0,2,2,2,2,2,2,2,2,2,2,2,2],
            [3,0,0,0,0,0,0,0,0,0,0,0,0,0,0,0,0,0,0,0,0,0,0,2],
            [2,2,2,2,2,2,0,2,2,2,2,0,2,2,2,2,2,2,2,2,3,2,2,2],
            [1,1,1,1,1,1,0,1,1,1,1,0,1,2,2,2,2,2,2,2,2,3,3,2],
            [1,0,0,0,0,0,0,0,1,0,0,0,1,2,0,0,0,0,0,2,0,0,0,3],
            [1,0,0,0,0,0,0,0,0,0,0,0,1,3,0,0,0,0,0,2,0,0,0,3],
            [1,0,0,0,0,0,0,0,1,0,0,0,1,2,0,0,0,0,0,2,2,0,2,2],
            [1,0,1,0,1,0,0,0,1,0,0,0,0,0,0,0,0,0,0,0,0,0,0,2],
            [1,0,0,1,0,0,0,0,1,0,0,0,1,2,0,0,0,0,0,2,2,0,2,2],
            [1,0,1,0,1,0,0,0,1,0,0,0,1,2,0,0,0,0,0,2,0,0,0,3],
            [1,0,0,0,0,0,0,0,1,0,0,0,1,2,0,0,0,0,0,2,0,0,0,3],
            [1,1,1,1,1,1,1,1,1,1,1,1,1,2,2,2,2,2,2,2,3,2,3,2]
        ],
        "walls": [
            "brickWall",
            "woodBrickWall",
            "bookShelfWall"
        ],
        "floor" : "floor",
        "ceiling" : "ceiling"
    },
    "player" : {
        "type": "Player",
        "x": 16,
        "y": 18.5,
        "dirX": -1,
        "dirY": 0
    },
    "objects" : [
        {
            "type": "Sprite",
            "x": 16,
            "y": 16,
            "width": 1,
            "height": 1,
            "textureId": "barrel"
        }
    ]
}
