{
    "map": {
        "width": 24,
        "height": 24,
        "data": [
            [4,4,4,4,4,4,4,4,4,4,4,4,4,4,4,4,7,7,7,7,7,7,7,7],
            [4,0,0,0,0,0,0,0,0,0,0,0,0,0,0,0,7,0,0,0,0,0,0,7],
            [4,0,1,0,0,0,0,0,0,0,0,0,0,0,0,0,0,0,0,0,0,0,0,7],
            [4,0,2,0,0,0,0,0,0,0,0,0,0,0,0,0,0,0,0,0,0,0,0,7],
            [4,0,3,0,0,0,0,0,0,0,0,0,0,0,0,0,7,0,0,0,0,0,0,7],
            [4,0,4,0,0,0,0,5,5,5,5,5,5,5,5,5,7,7,0,7,7,7,7,7],
            [4,0,5,0,0,0,0,5,0,5,0,5,0,5,0,5,7,0,0,0,7,7,7,1],
            [4,0,6,0,0,0,0,5,0,0,0,0,0,0,0,5,7,0,0,0,0,0,0,8],
            [4,0,7,0,0,0,0,0,0,0,0,0,0,0,0,0,0,0,0,0,7,7,7,1],
            [4,0,8,0,0,0,0,5,0,0,0,0,0,0,0,5,7,0,0,0,0,0,0,8],
            [4,0,0,0,0,0,0,5,0,0,0,0,0,0,0,5,7,0,0,0,7,7,7,1],
            [4,0,0,0,0,0,0,5,5,5,5,0,5,5,5,5,7,7,7,7,7,7,7,1],
            [6,6,6,6,6,6,6,6,6,6,6,0,6,6,6,6,6,6,6,6,6,6,6,6],
            [8,0,0,0,0,0,0,0,0,0,0,0,0,0,0,0,0,0,0,0,0,0,0,4],
            [6,6,6,6,6,6,0,6,6,6,6,0,6,6,6,6,6,6,6,6,6,6,6,6],
            [4,4,4,4,4,4,0,4,4,4,6,0,6,2,2,2,2,2,2,2,3,3,3,3],
            [4,0,0,0,0,0,0,0,0,4,6,0,6,2,0,0,0,0,0,2,0,0,0,2],
            [4,0,0,0,0,0,0,0,0,0,0,0,6,2,0,0,5,0,0,2,0,0,0,2],
            [4,0,0,0,0,0,0,0,4,0,0,0,6,2,0,0,0,0,0,2,2,0,2,2],
            [4,0,6,0,6,0,0,0,4,0,0,0,0,0,0,0,5,0,0,0,0,0,0,2],
            [4,0,0,5,0,0,0,0,4,0,0,0,0,2,0,0,0,0,0,2,2,0,2,2],
            [4,0,6,0,6,0,0,0,4,0,0,0,0,2,0,0,5,0,0,2,0,0,0,2],
            [4,0,0,0,0,0,0,0,4,0,0,0,0,2,0,0,0,0,0,2,0,0,0,2],
            [4,4,4,4,4,4,4,4,4,4,1,1,1,2,2,2,2,2,2,3,3,3,3,3]
        ],
        "walls": [
            "resources/textures/eagle.png",
            "resources/textures/redbrick.png",
            "resources/textures/purplestone.png",
            "resources/textures/greystone.png",
            "resources/textures/bluestone.png",
            "resources/textures/mossy.png",
            "resources/textures/wood.png",
            "resources/textures/colorstone.png"
        ],
        "objects": [
            "resources/textures/barrel.png",
            "resources/textures/greenlight.png",
            "resources/textures/pillar.png"
        ],
        "floor" : "resources/textures/greystone.png",
        "ceiling" : "resources/textures/wood.png"
    },
    "player" : {
        "type": "Player",
        "x": 11.5,
        "y": 22.5,
        "dirX": -1,
        "dirY": 0
    },
    "objects" : []
}
